R 1920 1080
NO textures/redbrick.xpm
SO textures/eagle.xpm
WE textures/colorstone.xpm
EA textures/mossy.xpm

S textures/barrel.xpm
F 220,100,0
C 225,30,0

        1111111111111111111111111
        1000000000110000000000001
        1000000001110000002000001
111111111000000000000000000000001
111000001011000001110000100001001
100000000000000001110100001011111
11110000001011100000010000011
11110000001000001010010001111
11000000110101000000000010001
1000200000S000001100000010001
10000000000000001101010010001
1100000111010101111101111000111
11110111 1110101 101111010001
11111111 1111111 111111111111