R 10000000 100000
NO textures/redbrick.xpm
SO textures/colorstone.xpm
EA textures/mossy.xpm

WE textures/eagle.xpm
F 0,00,0
S tex/barrel.xpm
C 0,0,0

111111111111
11000000000S1
1111111111111111cxvcxvcx