R 1920 1080
NO tex/001.xpm
SO tex/002.xpm
WE tex/003.xpm
EA tex/004.xpm

S tex/barrel.xpm
F 150,100,200
C 225,30,90

        1111111111111111111111111
        100001E000000000000000021
        1000010000010000000000001
111111111100000000000000000000011
100000000001000000010000100001111
10000000000000000101000000001
11110000001011110000001000001
11110000001000001010010001111
11000000110101000040000010001
10001000100000001100000010001
10000000000000101101010010001
11000001110101011111011110001
11110111 1110101 101111010001
11111111 1111111 111111111111