R 2000 1500
NO textures/redbrick.xpm
SO textures/colorstone.xpm
WE textures/eagle.xpm
EA textures/mossy.xpm

S tex/barrel.xpm
F 128,128,128
C 64,64,64

        1111111111111111111111111
        1000000000110000000000001
        1000000001110000000000001
111111111000000000000000000000001
111000001011002001110000100001001
1000000E0000002001110100001011111
11110000001011100000010000011
11110000001000001010010001111
11000000110101000000000010001
12222222222222221100000010001
10000000000000001101010010001
1100000111010101111101111000111
11110111 1110101 101111010001
11111111 1111111 111111111111 