R 1920 1080
NO textures/kawtar.xpm
SO textures/kawtar.xpm
WE textures/kawtar.xpm
EA textures/kawtar.xpm

S textures/barrel.xpm
F 220,100,0
C 225,30,0

        1111111111111111111111111
        1000000000110000002000001
        1000000001110000000000111
111111111000000000000000N00000011
111000001011000001110000100001001
100000000000000001110100000011111
111100000010111100000010000011
11110000001000001010010001111
11000000110101000000000010001
10001000000000001100000010001
10000000000000001101010010001
1100000111010101111101111000111
11110111 1110101 101111010001
11111111 1111111 111111111111