R 1920 1080
NO tex/001.xpm
SO tex/002.xpm
WE tex/003.xpm
EA tex/004.xpm

S tex/barrel.xpm
F 150,100,200
C 225,30,90

1111111
1N00001
1000001
1111111