R 1500 800
NO textures/redbrick.xpm
SO textures/colorstone.xpm
WE textures/eagle.xpm
EA textures/mossy.xpm

S textures/barrel.xpm
F 128,128,128
C 64,64,64

        1111111111111111111111111
        1000000001100000000000011
        1S00000001110000000000001
111111111000000000000000000000001
111000002222222222222000100001001
100000000000002001110100001011111
11110000000000000000100000011
11111111111111111101111111111
11111111111111111111111111111
11112222222221111112222200111
11000000110101000000000010001
10000000000000001100000010001
10000000000000001101010010001
1100000111010101111101111000111
11110111 1110101 101111010001
11111111 1111111 111111111111